BBB0BBBBBB
BWWWWWWWWB
BWWWWWWWW0
BWWWWWWWWB
BBBWWWWBBB
  BWWWWB
  BWWWWB
  BWWWHB
  BBBBBB