BBB0BBBB
BWWWWWWB
BWWWHWWB
BWWWWWWB
BBB0BBBB