BBB0BBBB
BWWWWWWB
BWWWWWWBBBBBBB
BWWWWWWHWWWWWB
BWWWWWWWWWWWW0
BWWWWWWWWWWWWB
BBBBBBBBBBBBBB