BBB0BBBB
BWWWWWWB
0WWWWWW0
BWWWWWWB
BWWWWWWB
BBBB1BBB