BBBB0BBB
BLWWWWWB
BWWWWWWB
0WWWWWW0
BWWWWWWB
BWWWWWWB
BWWWWWLB
BBBBBBBB