BBB1BBBB
BWWWWWWB
BWWWWWWB
BWWWWWWB
BBB0BBBB