BBBB0BBBBB
BWWWWWWWWB
BWWWWWWWWB
0WWWWWWWW0
BWWWWWWWWB
BWWWWWWWWB
BWWWWWWWWB
BBBBBBBBBB