BBB0BBBB
BWWWWWWB
0WWWWWW0
BWWWWWWB
BHWWWWWB
BBBB0BBB