BBBBB0BB
BWWWWWWB
BWWWWWWB
BWWWWWWB
BWWWWWWBBB
BWWWWWWWWB
BWWWWWWWHB
BWWWWWWWWB
BBBBBBBBBB