BBBB0BBB
BLWWWWWB
BWWWWWWB
0WWWWWW0
BWWHWWWB
BWWWWWWB
BWWWWWLB
BBBBBBBB